111111111111111111111111111
10010000000C0000000000000M1
100001111000000000000C00101
1000P1E0001C000000000000001
100000000000000000000000001
111111111111111111111111111