111111111111111111111111111
10010000000C0000000000001M1
1000011110000000000 0C00101
1000P1E0001C000000000000001
111111111111111111111111111
100000000000000000000000001
111111111111111111111111111