11111111111111111111111
10010000000C001000000E1
10010000000C00100000001
10010000000C00100000001
10010000000C00100000001
10010000000C00100000001
1001000P000C00100000001
10010000000C00100000001
11111111111111111111111