11111111111111111111111
12222222222222222222221
13010000000C00100000001
14010000000C00100000001
15010000000C00100000001
16010000000C00100000001
1701000P000C00100000001
18010000000C00100000001
11111111111111111111111