11111111111111111111111
10000000000000000000001
10010000000C00100000001
10010000000C00100000001
10010000000C00100000001
10010000000C00100000001
10010000P00C00100000001
10010000000C001E0000001
11111111111111111111111