1111111111111
10010000000C1
1000011110001
100P11E0001C1
1111111111111