1111111111111
1000000000001
1000000000001
1000000000001
1000000000001
1000000000001
1111111111111
1C0000E0000P1
1111111111111