1111111111111
10010000000C1
1000011110001
1000P1E0001C1
1000011110001
1000011100001
1000010000001
1000011110001
1111111111111